00000000000000000000000000
00000000000000000000000000
00110011001100110011001100
00110011001100110011001100
00110011001100110011001100
00110011001100110011001100
00110011001122110011001100
00110011001122110011001100
00110011001100110011001100
00110011000000000011001100
00110011000000000011001100
00000000001100110000000000
00000000001100110000000000
11001111000000000011110011
22001111000000000011110022
00000000001100110000000000
00000000001111110000000000
00110011001111110011001100
00110011001100110011001100
00110011001100110011001100
00110011001100110011001100
00110011000000000011001100
00110011000000000011001100
00110011000111100011001100
00000000000100100000000000
00000000000100100000000000

00000022000000220000000000
00000022000000220000000000
00110022000000110011001100
00110022000000110011001100
00110000000011110011221100
00110000000011110011221100
00000011000000000022000000
00000011000000000022000000
33000011000022000011331122
33000011000022000011331122
33330000001100002200330000
33330000001100002200330000
00111111333333220000331100
00111111333333220000331100
00000022331100110011001100
00000022331100110011001100
22110022001100110000001100
22110022001100110000001100
00110011001111110011221100
00110011001111110011221100
00110011001111110000000000
00110011001111110000000000
00110000000000000011001100
00110000000111100011001100
00110011000100100011111100
00110011000100100011111100

00000000110000001100000000
00000000110000001100000000
00333333110000000000000000
00333333110000000000222222
11333333000000000000000000
11333333000000000000000000
00333333000000110011111110
00333333000000110011111110
33333333111111110011000100
33333333111111000011000100
33333333000011000000000100
33333333000011000000000100
00330000000022222200003300
00330000000022222200003300
00000000000000000033333333
00110011000000000033333333
11100111100111111133333333
11100111100100000033333333
00000000001100000033333333
00000000001100111133333333
11000020000000111133333300
11000020000000000033333300
11110020000000000033333300
11110020000111100033333300
22111100000100100011000000
22111100000100100011000000

00333300000000000000003300
00333300000000000000003300
33330000001100000000000033
33330000111111111100000033
33000001111111111111000022
33000001111111111111110000
22000011111111111111111000
00000011111111111111111000
00000111000000111111001000
00000100000000001111001000
00000100200020001110000000
00000100200020001110000000
44001100000000001110004444
44001100111100001110004444
00001111111111111111000000
00001111111111111111000000
00011111111111111111100000
00011111111111111111100000
00111111111111111111110000
00000011111111111100000000
00111100111111110011110033
00111111001111001111110033
33000000000000001111003333
33000000000111100000003333
22330000000100100000333322
22330000000100100000333322

00000000111100000000000000
00000000111100000000000000
00000000110000002222220000
22001100110000000000220000
22001100000011000000000000
22001100000011000000000000
11001111110011110044440044
11001111110011110044440044
11000000110000000044000000
00000000000000000044000000
00000000444400444444000000
00001100444400444444000000
11110000441100111000001111
11110000441100111000001111
00000000440000000000220000
00000000440000000000220000
44444400440022001100200000
44444400440022001100200000
00000000000000000000201111
00000011110000000000201111
00000000111111111100000000
00000000110000001111000000
11111100000000000011110000
11110000000111100000110000
11000000000100100000000000
00000000000100100000000000

00000000000100103333000000
00000000000100103333000000
00100200100000000133100133
00100200100000000133100133
00100200100011000133100133
00100200100011000133100133
00110000110022001133001133
00110000110022001133001133
00110001220011001120003333
00110001000011000020003333
00110000003311330000111100
00110000003311330000111100
00000000013333331000000000
00000000013333331000000000
22000000113333331101111122
22000000003333330001111122
22222200000033000000222222
00000000110033001100000000
00110000110000001100000000
00110000110000001100000000
00111000001100110000011133
00111000000000000000011133
00001100000000000000333333
00001100000111100000333333
00000000000100100000003333
00001100000100100000113333

00000000000000222200000000
00000000000000000000000000
00002222222200000000220000
00002200000000000000220000
00002200000033002222220000
00002200000033000022220000
00220000003322000000220000
00220000003322000000220000
00000000332222000000222200
00000000332222000000002200
00220033222222002200000000
00220033222222002200000000
00020022220000002222000000
00020022220000002222000000
20000000220022222200000200
20000000220022222200000200
00022200000022223300002200
00022200000022223300002200
00220000000022330000222200
00220000000022330000222200
00222222000033000022000000
00000022000033000022000000
00000022000000000022000022
00000000000111100000002222
00000000000100100000000000
22220000000100100000000000

00001100001100000011000000
00001100001100110011000000
33111111001100000011100000
33111111001100220011100000
33333300001100110011000110
33333300000000110000000110
33444444444444444444440044
33444444444444444444440044
00110000000000000000000000
00110000000011110000000000
00001100000111111111112200
00001100000111110011000000
00110011000111113311000011
00110011000111113311222211
00000022000000333333330000
00000022002200333333330000
44440044444444440044444444
44440044444444440044444444
33330001000000000000000000
33330001000011110000000000
33331100100000010000001100
33331100100000010022111100
33001100100000000011001100
33221100100111100000001100
00000000000100100000000000
00000000000100100000000000

00000011000000000000330000
00000011000000000022330000
11000000000000330222200011
11000000000022330222200011
00000000330222200022330000
00000022330222200000330000
00000222200022330000000000
00000222200000330000000000
00000022330000000000000000
00000000330000000000000000
00000033003300330033000000
00000033223300332233000000
22110002222000022220001122
22110002222000022220001122
00000033223300332233000000
00000033003300330033000000
00000000000000000000000000
00000000220000002200000000
11000002222000022220000011
11000002222000022220000011
11000033223300332233000011
11000033003300330033000011
00000000000000000000000000
00001100000111100000110000
00001111000100100011110000
00001111000100100011110000

00000000000000000000000000
00000000000000000000000000
00011111000000000000111110
00010011000000000000110010
00110000110033330011000001
01000000110033330011000001
11000000113333333311000001
11000000113333333311000001
11000000113322223311100011
11000000113322223311100011
00000000444444444444111100
00111111444444444444111100
00111111222211222211111100
00111111222211222211111100
00001111220011002211111000
00001111220011002211111000
00001111111111111111111000
00001111111111111111111000
11331111112222111111113311
11330000002222000000003311
11333333333333333333333311
11333333333333333333333311
00003333330000003333333311
00003333330111103333333300
00000010000100100000100000
00000010000100100000100000
